border_size=1
usage=map

Ql, Xu, Xu, Xu, Ql
Ql, Uu^Vu, Xu, Uu^Vu, Ql
Ql, 1 Kud, Xu, 2 Kud, Ql
Ql, Cud, Ww, Cud, Ql
Ql, Ql, Ql, Ql, Ql
