border_size=1
usage=map

Aa^Fma, Ms^Xm, Aa^Fpa, Aa^Fma
Hh^Fds, 2 Koa, 1 Kv, Gll^Ftr
Ww^Ewf, Ww^Ewf, Ww^Ewf, Gll^Ftr
