border_size=1
usage=map

Gg, Gg, Gg, Gg, Gg, Gg, Gg, Gg, Gg, Gg, Gg, Gg, Gg, Gg, Gg, Gg, Gg, Gg, Gg, Gg, Gg, Gg, _off^_usr
Gg, Ww^Ewl, Gg^Efm, Hh, Hh, Hh, Re, Gs^Fp, Re^Vct, Mm, Mm, Mm^Xm, Mm, Gg, Re^Gvs, Gs^Fp, Gg^Vh, Gs^Fds, Gs^Fds, Gg, Ww^Ewl, Gg, _off^_usr
Gg, Ww^Ewf, Ww, Gg^Efm, Gg^Ve, Gs^Fds, Ds, Re, Gg, Hh^Fp, Gs^Fp, Mm^Xm, Gs^Fp, Mm, Gg, Re^Gvs, Ss, Gg^Efm, Gg^Efm, Gg^Efm, Ww^Vm, Ww^Ewl, _off^_usr
Gg, Ww^Vm, Gg, Re^Gvs, Re^Gvs, Gs^Fds, Gg, Gg, Hh^Fp, Hh^Fp, Gs^Fp, Mm^Xm, Gg, Gg^Vl, Re^Gvs, Ss, Ss, Gg, Dd, Gg, Gg, Ww, _off^_usr
Gg, Hh, Hh^Fp, Hh^Fp, Hh^Fp, Gg, Hh^Fp, Gg, Ds^Edpp, Gg, Gs^Fp, Mm^Xm, Gs^Fp, Gg, Gg^Wm, Re^Gvs, Hh^Fds, Gg, Ds, Mm, Hh^Fp, Hh, _off^_usr
Gg, Hh, Gg^Efm, Mm, Hh^Fp, Gg, Ww^Ewf, Dd^Edp, Dd, Gg, Hh^Fp, Mm^Xm, Gs^Fp, Hh^Fp, Dd^Edpp, Gs, Gg^Efm, Hh^Fds, Gg, Mm^Vhh, Hd, Hh, _off^_usr
Gg, Hh, Ds, Mm^Vhh, Re^Gvs, Re^Gvs, Ww, Gg, Gg^Efm, Hh^Fms, Gg^Efm, Mm^Xm, Gs, Hh^Fms, Mm, Dd, Gg, Gs, Gs^Esd, Gg, Hh^Fp, Hh, _off^_usr
Gg, Hh, Gs, Gs, Gg^Esd, Rp, Ss, Ss, Ww^Ewl, Gg^Efm, Gg^Efm, Hh^Fds, Gs, Gs, Gg, Gg, Hh^Fds, Hh^Fp, Gg^Efm, Gg^Efm, Gg, Hh, _off^_usr
Gg, Mm, Mm, Gg^Efm, Gg, Hh^Vo, Gs^Fp, Hh, Ww, Ww, Gg^Efm, Hh^Fms, Gs, Hh^Fp, Ww, Ww, Gg^Efm, Hh^Vo, Gg, Gg, Mm, Mm, _off^_usr
Gg, Ch, 3 Kh, Ch, Gg, Gg, Gg, Dd, Gg, Hh^Fp, Hh^Fp, Mm^Xm, Hh^Fp, Gg, Hh^Fp, Gg, Gs^Fp, Gg^Efm, Gg^Efm, Ch, 2 Kh, Cha, _off^_usr
Gg, Ch, Mm^Xm, Ch, Mm^Xm, Gg, Hh, Gg, Mm^Xm, Hh, Hh, Mm^Xm, Hh, Hh, Mm^Xm, Hh^Fp, Hh, Ds, Mm^Xm, Ch, Mm^Xm, Cha, _off^_usr
Gg, Mm^Xm, Mm^Xm, Mm^Xm, Mm^Xm, Hh, Gg, Mm^Xm, Ds, Hh, Hh^Fp, Mm^Xm, Mm, Hh, Gg, Mm^Xm, Gs^Fp, Hh, Mm^Xm, Mm^Xm, Mm^Xm, Mm^Xm, _off^_usr
Gg, Cha, 1 Kh, Ch, Gg, Gg, Mm^Vhh, Gs, Dd^Edpp, Ww, Gs^Fp, Mm^Xm, Gs^Fp, Hh^Fp, Gg, Hh, Hh^Vo, Re^Gvs, Gg, Ch, 4 Kh, Cha, _off^_usr
Gg, Cha, Mm, Ch, Gg, Gs, Gs, Hh^Fp, Ww, Gs, Ww, Mm^Xm, Gg, Dd, Ww, Ww, Ds, Gg, Gg^Efm, Ch, Mm, Cha, _off^_usr
Gg, Mm, Gg^Efm, Gg, Gs^Fp, Hh, Mm, Ww^Ewl, Hh^Fp, Gs^Fp, Gg, Hh^Fms, Gg, Gs^Fp, Gg, Mm, Dd, Gg^Efm, Gg, Gg, Gg, Mm, _off^_usr
Gg, Hh, Gg^Efm, Gg^Efm, Ds, Gg, Ww, Gg, Ds, Dd, Gg, Hh^Fds, Gs, Gg, Wwf, Hh^Fp, Gg, Gg^Efm, Gg, Hh, Mm^Vc, Hh, _off^_usr
Gg, Hh, Hh^Fp, Mm^Vc, Ds, Gg^Efm, Ww, Gs^Fds, Gg, Hh^Fms, Hh^Fp, Mm^Xm, Gs, Hh^Fms, Ww, Ww^Ewf, Ss, Gs^Fds, Gg, Hh, Hh^Fp, Hh, _off^_usr
Gg, Hh, Re^Gvs, Hh^Fp, Gg, Gs^Fds, Ss, Hh^Fms, Ww, Wwf, Mm, Mm^Xm, Hh^Fds, Hh^Fp, Hh^Fp, Gg, Gg, Ss, Rd, Gg, Gg, Hh, _off^_usr
Gg, Gs^Fp, Ww^Vm, Gg, Hh^Fp, Ss, Rp, Rp, Gg^Wm, Re^Gvs, Gs^Fp, Mm^Xm, Mm, Gs, Gs, Dd, Dd^Vda, Mm, Re^Gvs, Hh^Fp, Gg, Ww^Ewl, _off^_usr
Gg, Ww^Ewl, Ww, Gg^Efm, Gs^Fp, Rr^Vd, Re^Gvs, Hh^Fp, Hh^Fp, Gg^Vh, Gs^Fp, Mm^Xm, Hh^Fp, Gs^Vht, Re^Gvs, Gg^Efm, Hh^Fmf, Re^Gvs, Gg^Efm, Gs^Fds, Ww^Ewl, Ww^Vm, _off^_usr
Gg, Ww^Ewf, Hh, Hh, Hh, Gg^Efm, Re^Gvs, Gg^Efm, Mm, Gs^Fp, Mm, Mm^Xm, Hh^Fp, Hh^Fp, Gs^Fp, Gg^Efm, Gs^Fp, Mm, Hh, Gs^Fds, Gs^Fds, Ww, _off^_usr
Gg, Gg, Gg, Gg, Gg, Gg, Gg, Gg, Gg, Gg, Gg, Gg, Gg, Gg, Gg, Ds, Gg, Gg, Gg, Gg, Gg, Gg, _off^_usr
