border_size=1
usage=map

Mm^Xm, Mm^Xm, Mm^Xm, Mm^Xm, Mm^Xm, Mm^Xm, Mm^Xm, Mm^Xm, Mm^Xm
Mm^Xm, Hh^Vc, Cv, Mm^Xm, Mm^Xm, Mm^Xm, Cv, Hh^Vhh, Mm^Xm
Mm^Xm, 3 Kv, Cv, Gg^Efm, Ww, Gg^Efm, Cv, 2 Kv, Mm^Xm
Mm^Xm, Mm^Xm, Mm^Xm, Hh^Fds, Wwf, Hh^Fds, Mm^Xm, Mm^Xm, Mm^Xm
Mm^Xm, Mm^Xm, Cv, Hh^Fds, Ww, Hh^Fds, Cv, Mm^Xm, Mm^Xm
Mm^Xm, 1 Kv, Cv, Gg^Efm, Mm^Xm, Gg^Efm, Cv, 4 Kv, Mm^Xm
Mm^Xm, Hh^Vhh, Mm^Xm, Mm^Xm, Gg^Fet, Mm^Xm, Mm^Xm, Hh^Vc, Mm^Xm
Mm^Xm, Mm^Xm, Gg^Efm, Gg^Efm, Gg^Efm, Gg^Efm, Gg^Efm, Mm^Xm, Mm^Xm
